C 255,20 ,30


S ./textures/pillar.xpm
	R 900 600



	NO ./textures/north.xpm
           SO ./textures/south.xpm      
WE ./textures/west.xpm
EA 	./textures/east.xpm

F  000, 000, 00



        111111111111111111111111111111
111111111000200000000000011111
100000000000000000111000100001
110000100000000000000000001111
100001111111000000020000111111
1111111000000000W0000000000001
1111000000000011000000020000111111111111
1                            10000000001
1100000000000111100000000000111111111111111
100000000000111000000000000011
110000000000111000000000001111
110000000001111000000000000111
111111111111111111111111111111111
