C 99,102 ,248


S ./textures/pillar.xpm
	R 4000 1100



	NO ./textures/north.xpm 
           SO ./textures/south.xpm      
WE ./textures/west.xpm
EA 	./textures/east.xpm

F  000, 000, 00




1 1 1 1 1 1 1 1 1 1 1 1 1 1
1 0 0 0 0 0 0 0 0 0 0 0 0 1
1 0 0 0 0 0 0 0 0 0 0 0 0 0 1 1 1 1 1 1 1 1 1
1 1 1 1 1 0 0 0 0 0 0 0 0 0 0 0 0 0 0 0 0 0 1
        1 0 0 0 0 0 0 0 0 0 0 1 1 1 1 1 1 1 1
        1 0 0 0 0 0 0 0 0 0 0 1
        1 0 0 0 0 0 0 0 0 0 0 1           1 1 1 1 1 1
        1 1 1 1 1 1 1 1 0 0 0 1 1 1 1 1 1 1 0 0 0 0 1     1 1 1         1 1 1         1       1       1     1
        1 1 1 1 1 1 1 1 0 0 0 0 0 0 0 0 0 0 0 0 0 0 1     1     1       1     1       1       1       1     1
                      1 0 0 0 0 0 0 0 0 0 0 0 0 0 0 1 1 1 1 1 1         1 1 1 1       1       1       1 1 1 1
                      1 0 0 0 0 0 N 0 0 0 0 0 0 0 0 1     1     1       1     1       1       1       1     1
      1 1 1 1 1 1 1 1 1 0 0 0 0 0 0 0 0 0 0 0 0 0 0 1     1 1 1 1 1 1 1 1     1 1 1 1 1 1 1 1 1 1 1 1 1     1
    1 0 0 0 0 0 0 0 0 0 0 0 0 0 0 0 0 0 0 0 0 0 0 0 1
    1 0 0 0 0 0 0 0 0 0 0 0 0 0 0 0 0 0 0 0 0 0 0 0 1
    1 0 0 0 0 0 0 1 1 1 1 1 1 1 1 1 1 1 1 1 1 0 0 1 1
    1 0 0 0 0 0 0 1                         1 0 0 0 1
    1 0 0 0 0 0 0 0 1 1 1 1 1 1 1 1         1 0 0 0 0 1
    1 0 0 0 0 0 0 0 0 0 0 0 0 0 0 1 1 1 1 1 1 1 1 1 0 1
      1 1 1 1 1 1 1 1 1 1 1 1 1 0 0 0 0 0 0 0 0 0 0 0 1
                                1 1 1 1 1 1 0 0 1 1 1
                                          1 0 0 1
                          1 1 1           1 0 0 1 
                        1 0 0 0 1 1 1 1 1 1 0 0 1
                        1 0 0 0 0 0 0 0 0 1 1 1 1
                        1 0 0 0 1 1 1 1 1
                          1 1 1
